"","Direccion","Separacion","n","nYes","nNo","p","condicion","observadores","grupo"
"1","0",3,9,2,7,0.222222222222222,"pre","aaf","cl"
"2","0",5,7,4,3,0.571428571428571,"pre","aaf","cl"
"3","0",8,12,6,6,0.5,"pre","aaf","cl"
"4","0",11,9,2,7,0.222222222222222,"pre","aaf","cl"
"5","0",14,14,9,5,0.642857142857143,"pre","aaf","cl"
"6","0",17,14,0,14,0,"pre","aaf","cl"
"7","0",20,17,2,15,0.117647058823529,"pre","aaf","cl"
"8","135",3,14,7,7,0.5,"pre","aaf","cl"
"9","135",5,10,4,6,0.4,"pre","aaf","cl"
"10","135",8,12,4,8,0.333333333333333,"pre","aaf","cl"
"11","135",11,15,6,9,0.4,"pre","aaf","cl"
"12","135",14,8,2,6,0.25,"pre","aaf","cl"
"13","135",17,10,2,8,0.2,"pre","aaf","cl"
"14","135",20,10,2,8,0.2,"pre","aaf","cl"
"15","45",3,11,3,8,0.272727272727273,"pre","aaf","cl"
"16","45",5,14,8,6,0.571428571428571,"pre","aaf","cl"
"17","45",8,14,7,7,0.5,"pre","aaf","cl"
"18","45",11,6,2,4,0.333333333333333,"pre","aaf","cl"
"19","45",14,13,3,10,0.230769230769231,"pre","aaf","cl"
"20","45",17,12,3,9,0.25,"pre","aaf","cl"
"21","45",20,6,1,5,0.166666666666667,"pre","aaf","cl"
"22","90",3,10,3,7,0.3,"pre","aaf","cl"
"23","90",5,14,2,12,0.142857142857143,"pre","aaf","cl"
"24","90",8,8,7,1,0.875,"pre","aaf","cl"
"25","90",11,15,3,12,0.2,"pre","aaf","cl"
"26","90",14,8,3,5,0.375,"pre","aaf","cl"
"27","90",17,10,2,8,0.2,"pre","aaf","cl"
"28","90",20,13,0,13,0,"pre","aaf","cl"
"29","0",3,9,5,4,0.555555555555556,"pre","afb","rt"
"30","0",5,7,6,1,0.857142857142857,"pre","afb","rt"
"31","0",8,13,7,6,0.538461538461538,"pre","afb","rt"
"32","0",11,9,5,4,0.555555555555556,"pre","afb","rt"
"33","0",14,15,3,12,0.2,"pre","afb","rt"
"34","0",17,14,3,11,0.214285714285714,"pre","afb","rt"
"35","0",20,17,4,13,0.235294117647059,"pre","afb","rt"
"36","135",3,14,11,3,0.785714285714286,"pre","afb","rt"
"37","135",5,11,8,3,0.727272727272727,"pre","afb","rt"
"38","135",8,12,7,5,0.583333333333333,"pre","afb","rt"
"39","135",11,16,2,14,0.125,"pre","afb","rt"
"40","135",14,10,5,5,0.5,"pre","afb","rt"
"41","135",17,11,6,5,0.545454545454545,"pre","afb","rt"
"42","135",20,10,5,5,0.5,"pre","afb","rt"
"43","45",3,13,9,4,0.692307692307692,"pre","afb","rt"
"44","45",5,16,10,6,0.625,"pre","afb","rt"
"45","45",8,14,5,9,0.357142857142857,"pre","afb","rt"
"46","45",11,8,4,4,0.5,"pre","afb","rt"
"47","45",14,14,6,8,0.428571428571429,"pre","afb","rt"
"48","45",17,12,5,7,0.416666666666667,"pre","afb","rt"
"49","45",20,7,3,4,0.428571428571429,"pre","afb","rt"
"50","90",3,11,9,2,0.818181818181818,"pre","afb","rt"
"51","90",5,14,7,7,0.5,"pre","afb","rt"
"52","90",8,9,4,5,0.444444444444444,"pre","afb","rt"
"53","90",11,15,3,12,0.2,"pre","afb","rt"
"54","90",14,9,1,8,0.111111111111111,"pre","afb","rt"
"55","90",17,11,3,8,0.272727272727273,"pre","afb","rt"
"56","90",20,13,2,11,0.153846153846154,"pre","afb","rt"
"57","0",3,9,6,3,0.666666666666667,"pre","agm","cl"
"58","0",5,6,4,2,0.666666666666667,"pre","agm","cl"
"59","0",8,12,8,4,0.666666666666667,"pre","agm","cl"
"60","0",11,7,3,4,0.428571428571429,"pre","agm","cl"
"61","0",14,12,3,9,0.25,"pre","agm","cl"
"62","0",17,13,3,10,0.230769230769231,"pre","agm","cl"
"63","0",20,17,6,11,0.352941176470588,"pre","agm","cl"
"64","135",3,12,7,5,0.583333333333333,"pre","agm","cl"
"65","135",5,10,6,4,0.6,"pre","agm","cl"
"66","135",8,12,5,7,0.416666666666667,"pre","agm","cl"
"67","135",11,14,6,8,0.428571428571429,"pre","agm","cl"
"68","135",14,9,1,8,0.111111111111111,"pre","agm","cl"
"69","135",17,10,2,8,0.2,"pre","agm","cl"
"70","135",20,9,3,6,0.333333333333333,"pre","agm","cl"
"71","45",3,12,8,4,0.666666666666667,"pre","agm","cl"
"72","45",5,15,10,5,0.666666666666667,"pre","agm","cl"
"73","45",8,12,6,6,0.5,"pre","agm","cl"
"74","45",11,8,5,3,0.625,"pre","agm","cl"
"75","45",14,12,6,6,0.5,"pre","agm","cl"
"76","45",17,7,1,6,0.142857142857143,"pre","agm","cl"
"77","45",20,7,1,6,0.142857142857143,"pre","agm","cl"
"78","90",3,9,5,4,0.555555555555556,"pre","agm","cl"
"79","90",5,14,11,3,0.785714285714286,"pre","agm","cl"
"80","90",8,7,3,4,0.428571428571429,"pre","agm","cl"
"81","90",11,13,4,9,0.307692307692308,"pre","agm","cl"
"82","90",14,9,1,8,0.111111111111111,"pre","agm","cl"
"83","90",17,10,2,8,0.2,"pre","agm","cl"
"84","90",20,10,2,8,0.2,"pre","agm","cl"
"85","0",3,9,7,2,0.777777777777778,"pre","cic","rt"
"86","0",5,7,5,2,0.714285714285714,"pre","cic","rt"
"87","0",8,13,8,5,0.615384615384615,"pre","cic","rt"
"88","0",11,9,3,6,0.333333333333333,"pre","cic","rt"
"89","0",14,15,5,10,0.333333333333333,"pre","cic","rt"
"90","0",17,14,2,12,0.142857142857143,"pre","cic","rt"
"91","0",20,17,6,11,0.352941176470588,"pre","cic","rt"
"92","135",3,14,9,5,0.642857142857143,"pre","cic","rt"
"93","135",5,11,2,9,0.181818181818182,"pre","cic","rt"
"94","135",8,12,7,5,0.583333333333333,"pre","cic","rt"
"95","135",11,16,4,12,0.25,"pre","cic","rt"
"96","135",14,10,2,8,0.2,"pre","cic","rt"
"97","135",17,10,2,8,0.2,"pre","cic","rt"
"98","135",20,10,2,8,0.2,"pre","cic","rt"
"99","45",3,13,10,3,0.769230769230769,"pre","cic","rt"
"100","45",5,16,7,9,0.4375,"pre","cic","rt"
"101","45",8,14,7,7,0.5,"pre","cic","rt"
"102","45",11,8,3,5,0.375,"pre","cic","rt"
"103","45",14,14,6,8,0.428571428571429,"pre","cic","rt"
"104","45",17,12,3,9,0.25,"pre","cic","rt"
"105","45",20,7,2,5,0.285714285714286,"pre","cic","rt"
"106","90",3,12,8,4,0.666666666666667,"pre","cic","rt"
"107","90",5,14,9,5,0.642857142857143,"pre","cic","rt"
"108","90",8,9,6,3,0.666666666666667,"pre","cic","rt"
"109","90",11,15,5,10,0.333333333333333,"pre","cic","rt"
"110","90",14,7,4,3,0.571428571428571,"pre","cic","rt"
"111","90",17,11,4,7,0.363636363636364,"pre","cic","rt"
"112","90",20,13,1,12,0.0769230769230769,"pre","cic","rt"
"113","0",3,9,5,4,0.555555555555556,"pre","jjr","lt"
"114","0",5,7,4,3,0.571428571428571,"pre","jjr","lt"
"115","0",8,13,9,4,0.692307692307692,"pre","jjr","lt"
"116","0",11,9,4,5,0.444444444444444,"pre","jjr","lt"
"117","0",14,15,6,9,0.4,"pre","jjr","lt"
"118","0",17,13,1,12,0.0769230769230769,"pre","jjr","lt"
"119","0",20,17,3,14,0.176470588235294,"pre","jjr","lt"
"120","135",3,14,8,6,0.571428571428571,"pre","jjr","lt"
"121","135",5,11,9,2,0.818181818181818,"pre","jjr","lt"
"122","135",8,12,3,9,0.25,"pre","jjr","lt"
"123","135",11,16,4,12,0.25,"pre","jjr","lt"
"124","135",14,10,3,7,0.3,"pre","jjr","lt"
"125","135",17,11,1,10,0.0909090909090909,"pre","jjr","lt"
"126","135",20,9,1,8,0.111111111111111,"pre","jjr","lt"
"127","45",3,13,6,7,0.461538461538462,"pre","jjr","lt"
"128","45",5,16,12,4,0.75,"pre","jjr","lt"
"129","45",8,14,9,5,0.642857142857143,"pre","jjr","lt"
"130","45",11,8,4,4,0.5,"pre","jjr","lt"
"131","45",14,14,6,8,0.428571428571429,"pre","jjr","lt"
"132","45",17,12,6,6,0.5,"pre","jjr","lt"
"133","45",20,7,0,7,0,"pre","jjr","lt"
"134","90",3,12,5,7,0.416666666666667,"pre","jjr","lt"
"135","90",5,14,9,5,0.642857142857143,"pre","jjr","lt"
"136","90",8,9,0,9,0,"pre","jjr","lt"
"137","90",11,15,5,10,0.333333333333333,"pre","jjr","lt"
"138","90",14,9,3,6,0.333333333333333,"pre","jjr","lt"
"139","90",17,11,4,7,0.363636363636364,"pre","jjr","lt"
"140","90",20,13,2,11,0.153846153846154,"pre","jjr","lt"
"141","0",3,9,5,4,0.555555555555556,"pre","lrc","cl"
"142","0",5,5,4,1,0.8,"pre","lrc","cl"
"143","0",8,12,8,4,0.666666666666667,"pre","lrc","cl"
"144","0",11,7,4,3,0.571428571428571,"pre","lrc","cl"
"145","0",14,12,5,7,0.416666666666667,"pre","lrc","cl"
"146","0",17,13,2,11,0.153846153846154,"pre","lrc","cl"
"147","0",20,16,2,14,0.125,"pre","lrc","cl"
"148","135",3,14,10,4,0.714285714285714,"pre","lrc","cl"
"149","135",5,10,7,3,0.7,"pre","lrc","cl"
"150","135",8,10,8,2,0.8,"pre","lrc","cl"
"151","135",11,15,6,9,0.4,"pre","lrc","cl"
"152","135",14,10,2,8,0.2,"pre","lrc","cl"
"153","135",17,11,1,10,0.0909090909090909,"pre","lrc","cl"
"154","135",20,10,2,8,0.2,"pre","lrc","cl"
"155","45",3,12,7,5,0.583333333333333,"pre","lrc","cl"
"156","45",5,15,10,5,0.666666666666667,"pre","lrc","cl"
"157","45",8,12,4,8,0.333333333333333,"pre","lrc","cl"
"158","45",11,8,2,6,0.25,"pre","lrc","cl"
"159","45",14,13,5,8,0.384615384615385,"pre","lrc","cl"
"160","45",17,11,1,10,0.0909090909090909,"pre","lrc","cl"
"161","45",20,7,0,7,0,"pre","lrc","cl"
"162","90",3,12,10,2,0.833333333333333,"pre","lrc","cl"
"163","90",5,13,7,6,0.538461538461538,"pre","lrc","cl"
"164","90",8,9,5,4,0.555555555555556,"pre","lrc","cl"
"165","90",11,15,4,11,0.266666666666667,"pre","lrc","cl"
"166","90",14,9,2,7,0.222222222222222,"pre","lrc","cl"
"167","90",17,10,3,7,0.3,"pre","lrc","cl"
"168","90",20,13,2,11,0.153846153846154,"pre","lrc","cl"
"169","0",3,8,1,7,0.125,"pre","mab","lt"
"170","0",5,5,3,2,0.6,"pre","mab","lt"
"171","0",8,11,6,5,0.545454545454545,"pre","mab","lt"
"172","0",11,6,3,3,0.5,"pre","mab","lt"
"173","0",14,12,1,11,0.0833333333333333,"pre","mab","lt"
"174","0",17,11,4,7,0.363636363636364,"pre","mab","lt"
"175","0",20,13,4,9,0.307692307692308,"pre","mab","lt"
"176","135",3,12,9,3,0.75,"pre","mab","lt"
"177","135",5,5,5,0,1,"pre","mab","lt"
"178","135",8,10,6,4,0.6,"pre","mab","lt"
"179","135",11,10,6,4,0.6,"pre","mab","lt"
"180","135",14,6,2,4,0.333333333333333,"pre","mab","lt"
"181","135",17,11,2,9,0.181818181818182,"pre","mab","lt"
"182","135",20,9,4,5,0.444444444444444,"pre","mab","lt"
"183","45",3,11,10,1,0.909090909090909,"pre","mab","lt"
"184","45",5,11,8,3,0.727272727272727,"pre","mab","lt"
"185","45",8,13,7,6,0.538461538461538,"pre","mab","lt"
"186","45",11,4,4,0,1,"pre","mab","lt"
"187","45",14,12,6,6,0.5,"pre","mab","lt"
"188","45",17,9,2,7,0.222222222222222,"pre","mab","lt"
"189","45",20,5,2,3,0.4,"pre","mab","lt"
"190","90",3,8,7,1,0.875,"pre","mab","lt"
"191","90",5,6,4,2,0.666666666666667,"pre","mab","lt"
"192","90",8,7,6,1,0.857142857142857,"pre","mab","lt"
"193","90",11,12,4,8,0.333333333333333,"pre","mab","lt"
"194","90",14,9,6,3,0.666666666666667,"pre","mab","lt"
"195","90",17,9,4,5,0.444444444444444,"pre","mab","lt"
"196","90",20,12,1,11,0.0833333333333333,"pre","mab","lt"
"197","0",3,9,4,5,0.444444444444444,"pre","mdn","lt"
"198","0",5,7,7,0,1,"pre","mdn","lt"
"199","0",8,13,8,5,0.615384615384615,"pre","mdn","lt"
"200","0",11,9,3,6,0.333333333333333,"pre","mdn","lt"
"201","0",14,14,6,8,0.428571428571429,"pre","mdn","lt"
"202","0",17,14,4,10,0.285714285714286,"pre","mdn","lt"
"203","0",20,17,5,12,0.294117647058824,"pre","mdn","lt"
"204","135",3,14,10,4,0.714285714285714,"pre","mdn","lt"
"205","135",5,11,8,3,0.727272727272727,"pre","mdn","lt"
"206","135",8,12,5,7,0.416666666666667,"pre","mdn","lt"
"207","135",11,16,5,11,0.3125,"pre","mdn","lt"
"208","135",14,10,3,7,0.3,"pre","mdn","lt"
"209","135",17,11,4,7,0.363636363636364,"pre","mdn","lt"
"210","135",20,10,0,10,0,"pre","mdn","lt"
"211","45",3,13,7,6,0.538461538461538,"pre","mdn","lt"
"212","45",5,16,14,2,0.875,"pre","mdn","lt"
"213","45",8,13,7,6,0.538461538461538,"pre","mdn","lt"
"214","45",11,8,6,2,0.75,"pre","mdn","lt"
"215","45",14,13,6,7,0.461538461538462,"pre","mdn","lt"
"216","45",17,10,4,6,0.4,"pre","mdn","lt"
"217","45",20,6,0,6,0,"pre","mdn","lt"
"218","90",3,11,5,6,0.454545454545455,"pre","mdn","lt"
"219","90",5,14,8,6,0.571428571428571,"pre","mdn","lt"
"220","90",8,9,2,7,0.222222222222222,"pre","mdn","lt"
"221","90",11,13,4,9,0.307692307692308,"pre","mdn","lt"
"222","90",14,9,3,6,0.333333333333333,"pre","mdn","lt"
"223","90",17,10,5,5,0.5,"pre","mdn","lt"
"224","90",20,13,1,12,0.0769230769230769,"pre","mdn","lt"
"225","0",3,9,7,2,0.777777777777778,"pre","msz","rt"
"226","0",5,7,2,5,0.285714285714286,"pre","msz","rt"
"227","0",8,13,9,4,0.692307692307692,"pre","msz","rt"
"228","0",11,9,3,6,0.333333333333333,"pre","msz","rt"
"229","0",14,15,5,10,0.333333333333333,"pre","msz","rt"
"230","0",17,14,1,13,0.0714285714285714,"pre","msz","rt"
"231","0",20,17,1,16,0.0588235294117647,"pre","msz","rt"
"232","135",3,14,11,3,0.785714285714286,"pre","msz","rt"
"233","135",5,11,8,3,0.727272727272727,"pre","msz","rt"
"234","135",8,12,4,8,0.333333333333333,"pre","msz","rt"
"235","135",11,16,7,9,0.4375,"pre","msz","rt"
"236","135",14,9,1,8,0.111111111111111,"pre","msz","rt"
"237","135",17,11,2,9,0.181818181818182,"pre","msz","rt"
"238","135",20,9,1,8,0.111111111111111,"pre","msz","rt"
"239","45",3,13,12,1,0.923076923076923,"pre","msz","rt"
"240","45",5,16,12,4,0.75,"pre","msz","rt"
"241","45",8,14,6,8,0.428571428571429,"pre","msz","rt"
"242","45",11,6,2,4,0.333333333333333,"pre","msz","rt"
"243","45",14,14,7,7,0.5,"pre","msz","rt"
"244","45",17,12,3,9,0.25,"pre","msz","rt"
"245","45",20,7,3,4,0.428571428571429,"pre","msz","rt"
"246","90",3,12,8,4,0.666666666666667,"pre","msz","rt"
"247","90",5,14,10,4,0.714285714285714,"pre","msz","rt"
"248","90",8,9,3,6,0.333333333333333,"pre","msz","rt"
"249","90",11,15,9,6,0.6,"pre","msz","rt"
"250","90",14,9,1,8,0.111111111111111,"pre","msz","rt"
"251","90",17,11,3,8,0.272727272727273,"pre","msz","rt"
"252","90",20,13,4,9,0.307692307692308,"pre","msz","rt"
"253","0",3,7,6,1,0.857142857142857,"pre","nga","rt"
"254","0",5,6,2,4,0.333333333333333,"pre","nga","rt"
"255","0",8,13,7,6,0.538461538461538,"pre","nga","rt"
"256","0",11,8,5,3,0.625,"pre","nga","rt"
"257","0",14,15,6,9,0.4,"pre","nga","rt"
"258","0",17,14,4,10,0.285714285714286,"pre","nga","rt"
"259","0",20,17,6,11,0.352941176470588,"pre","nga","rt"
"260","135",3,12,11,1,0.916666666666667,"pre","nga","rt"
"261","135",5,11,10,1,0.909090909090909,"pre","nga","rt"
"262","135",8,10,6,4,0.6,"pre","nga","rt"
"263","135",11,16,8,8,0.5,"pre","nga","rt"
"264","135",14,8,5,3,0.625,"pre","nga","rt"
"265","135",17,10,2,8,0.2,"pre","nga","rt"
"266","135",20,9,2,7,0.222222222222222,"pre","nga","rt"
"267","45",3,13,10,3,0.769230769230769,"pre","nga","rt"
"268","45",5,14,7,7,0.5,"pre","nga","rt"
"269","45",8,13,7,6,0.538461538461538,"pre","nga","rt"
"270","45",11,7,5,2,0.714285714285714,"pre","nga","rt"
"271","45",14,13,7,6,0.538461538461538,"pre","nga","rt"
"272","45",17,12,5,7,0.416666666666667,"pre","nga","rt"
"273","45",20,6,2,4,0.333333333333333,"pre","nga","rt"
"274","90",3,11,6,5,0.545454545454545,"pre","nga","rt"
"275","90",5,14,7,7,0.5,"pre","nga","rt"
"276","90",8,9,5,4,0.555555555555556,"pre","nga","rt"
"277","90",11,13,5,8,0.384615384615385,"pre","nga","rt"
"278","90",14,8,4,4,0.5,"pre","nga","rt"
"279","90",17,11,5,6,0.454545454545455,"pre","nga","rt"
"280","90",20,12,2,10,0.166666666666667,"pre","nga","rt"
"281","0",3,8,8,0,1,"pre","pab","cl"
"282","0",5,6,6,0,1,"pre","pab","cl"
"283","0",8,13,9,4,0.692307692307692,"pre","pab","cl"
"284","0",11,8,8,0,1,"pre","pab","cl"
"285","0",14,14,10,4,0.714285714285714,"pre","pab","cl"
"286","0",17,14,7,7,0.5,"pre","pab","cl"
"287","0",20,17,8,9,0.470588235294118,"pre","pab","cl"
"288","135",3,13,12,1,0.923076923076923,"pre","pab","cl"
"289","135",5,11,9,2,0.818181818181818,"pre","pab","cl"
"290","135",8,10,8,2,0.8,"pre","pab","cl"
"291","135",11,15,9,6,0.6,"pre","pab","cl"
"292","135",14,10,4,6,0.4,"pre","pab","cl"
"293","135",17,9,3,6,0.333333333333333,"pre","pab","cl"
"294","135",20,10,4,6,0.4,"pre","pab","cl"
"295","45",3,12,10,2,0.833333333333333,"pre","pab","cl"
"296","45",5,15,12,3,0.8,"pre","pab","cl"
"297","45",8,13,12,1,0.923076923076923,"pre","pab","cl"
"298","45",11,8,8,0,1,"pre","pab","cl"
"299","45",14,14,7,7,0.5,"pre","pab","cl"
"300","45",17,11,5,6,0.454545454545455,"pre","pab","cl"
"301","45",20,7,1,6,0.142857142857143,"pre","pab","cl"
"302","90",3,12,10,2,0.833333333333333,"pre","pab","cl"
"303","90",5,14,12,2,0.857142857142857,"pre","pab","cl"
"304","90",8,8,5,3,0.625,"pre","pab","cl"
"305","90",11,14,10,4,0.714285714285714,"pre","pab","cl"
"306","90",14,7,5,2,0.714285714285714,"pre","pab","cl"
"307","90",17,10,1,9,0.1,"pre","pab","cl"
"308","90",20,12,3,9,0.25,"pre","pab","cl"
"309","0",3,11,11,0,1,"pre","at-","hk"
"310","0",5,12,9,3,0.75,"pre","at-","hk"
"311","0",8,11,11,0,1,"pre","at-","hk"
"312","0",11,12,10,2,0.833333333333333,"pre","at-","hk"
"313","0",14,12,7,5,0.583333333333333,"pre","at-","hk"
"314","0",17,12,7,5,0.583333333333333,"pre","at-","hk"
"315","0",20,12,7,5,0.583333333333333,"pre","at-","hk"
"316","45",3,12,8,4,0.666666666666667,"pre","at-","hk"
"317","45",5,12,9,3,0.75,"pre","at-","hk"
"318","45",8,11,9,2,0.818181818181818,"pre","at-","hk"
"319","45",11,11,6,5,0.545454545454545,"pre","at-","hk"
"320","45",14,12,5,7,0.416666666666667,"pre","at-","hk"
"321","45",17,12,4,8,0.333333333333333,"pre","at-","hk"
"322","45",20,12,4,8,0.333333333333333,"pre","at-","hk"
"323","90",3,12,8,4,0.666666666666667,"pre","at-","hk"
"324","90",5,12,9,3,0.75,"pre","at-","hk"
"325","90",8,10,9,1,0.9,"pre","at-","hk"
"326","90",11,12,9,3,0.75,"pre","at-","hk"
"327","90",14,12,9,3,0.75,"pre","at-","hk"
"328","90",17,11,5,6,0.454545454545455,"pre","at-","hk"
"329","90",20,12,6,6,0.5,"pre","at-","hk"
"330","135",3,12,11,1,0.916666666666667,"pre","at-","hk"
"331","135",5,12,9,3,0.75,"pre","at-","hk"
"332","135",8,12,7,5,0.583333333333333,"pre","at-","hk"
"333","135",11,12,8,4,0.666666666666667,"pre","at-","hk"
"334","135",14,12,6,6,0.5,"pre","at-","hk"
"335","135",17,12,7,5,0.583333333333333,"pre","at-","hk"
"336","135",20,12,2,10,0.166666666666667,"pre","at-","hk"
"337","0",3,12,11,1,0.916666666666667,"pre","lfa","hk"
"338","0",5,12,9,3,0.75,"pre","lfa","hk"
"339","0",8,12,10,2,0.833333333333333,"pre","lfa","hk"
"340","0",11,12,8,4,0.666666666666667,"pre","lfa","hk"
"341","0",14,12,8,4,0.666666666666667,"pre","lfa","hk"
"342","0",17,12,4,8,0.333333333333333,"pre","lfa","hk"
"343","0",20,12,3,9,0.25,"pre","lfa","hk"
"344","45",3,12,11,1,0.916666666666667,"pre","lfa","hk"
"345","45",5,12,10,2,0.833333333333333,"pre","lfa","hk"
"346","45",8,12,6,6,0.5,"pre","lfa","hk"
"347","45",11,11,6,5,0.545454545454545,"pre","lfa","hk"
"348","45",14,12,4,8,0.333333333333333,"pre","lfa","hk"
"349","45",17,12,0,12,0,"pre","lfa","hk"
"350","45",20,11,2,9,0.181818181818182,"pre","lfa","hk"
"351","90",3,12,7,5,0.583333333333333,"pre","lfa","hk"
"352","90",5,12,9,3,0.75,"pre","lfa","hk"
"353","90",8,12,7,5,0.583333333333333,"pre","lfa","hk"
"354","90",11,11,9,2,0.818181818181818,"pre","lfa","hk"
"355","90",14,12,6,6,0.5,"pre","lfa","hk"
"356","90",17,12,3,9,0.25,"pre","lfa","hk"
"357","90",20,12,3,9,0.25,"pre","lfa","hk"
"358","135",3,12,8,4,0.666666666666667,"pre","lfa","hk"
"359","135",5,12,10,2,0.833333333333333,"pre","lfa","hk"
"360","135",8,12,6,6,0.5,"pre","lfa","hk"
"361","135",11,12,5,7,0.416666666666667,"pre","lfa","hk"
"362","135",14,12,3,9,0.25,"pre","lfa","hk"
"363","135",17,12,4,8,0.333333333333333,"pre","lfa","hk"
"364","135",20,12,2,10,0.166666666666667,"pre","lfa","hk"
"365","0",3,12,5,7,0.416666666666667,"pre","lms","hk"
"366","0",5,12,7,5,0.583333333333333,"pre","lms","hk"
"367","0",8,11,5,6,0.454545454545455,"pre","lms","hk"
"368","0",11,12,6,6,0.5,"pre","lms","hk"
"369","0",14,11,3,8,0.272727272727273,"pre","lms","hk"
"370","0",17,12,3,9,0.25,"pre","lms","hk"
"371","0",20,12,3,9,0.25,"pre","lms","hk"
"372","45",3,12,8,4,0.666666666666667,"pre","lms","hk"
"373","45",5,11,6,5,0.545454545454545,"pre","lms","hk"
"374","45",8,12,5,7,0.416666666666667,"pre","lms","hk"
"375","45",11,10,4,6,0.4,"pre","lms","hk"
"376","45",14,12,2,10,0.166666666666667,"pre","lms","hk"
"377","45",17,12,2,10,0.166666666666667,"pre","lms","hk"
"378","45",20,12,2,10,0.166666666666667,"pre","lms","hk"
"379","90",3,11,5,6,0.454545454545455,"pre","lms","hk"
"380","90",5,11,4,7,0.363636363636364,"pre","lms","hk"
"381","90",8,10,4,6,0.4,"pre","lms","hk"
"382","90",11,12,4,8,0.333333333333333,"pre","lms","hk"
"383","90",14,12,3,9,0.25,"pre","lms","hk"
"384","90",17,12,1,11,0.0833333333333333,"pre","lms","hk"
"385","90",20,12,3,9,0.25,"pre","lms","hk"
"386","135",3,12,6,6,0.5,"pre","lms","hk"
"387","135",5,12,7,5,0.583333333333333,"pre","lms","hk"
"388","135",8,12,5,7,0.416666666666667,"pre","lms","hk"
"389","135",11,12,1,11,0.0833333333333333,"pre","lms","hk"
"390","135",14,12,3,9,0.25,"pre","lms","hk"
"391","135",17,11,0,11,0,"pre","lms","hk"
"392","135",20,11,4,7,0.363636363636364,"pre","lms","hk"
"393","0",3,12,8,4,0.666666666666667,"pre","mcm","hk"
"394","0",5,12,11,1,0.916666666666667,"pre","mcm","hk"
"395","0",8,12,8,4,0.666666666666667,"pre","mcm","hk"
"396","0",11,11,6,5,0.545454545454545,"pre","mcm","hk"
"397","0",14,12,7,5,0.583333333333333,"pre","mcm","hk"
"398","0",17,12,4,8,0.333333333333333,"pre","mcm","hk"
"399","0",20,12,3,9,0.25,"pre","mcm","hk"
"400","45",3,12,5,7,0.416666666666667,"pre","mcm","hk"
"401","45",5,12,7,5,0.583333333333333,"pre","mcm","hk"
"402","45",8,12,5,7,0.416666666666667,"pre","mcm","hk"
"403","45",11,12,5,7,0.416666666666667,"pre","mcm","hk"
"404","45",14,12,1,11,0.0833333333333333,"pre","mcm","hk"
"405","45",17,12,3,9,0.25,"pre","mcm","hk"
"406","45",20,11,3,8,0.272727272727273,"pre","mcm","hk"
"407","90",3,11,7,4,0.636363636363636,"pre","mcm","hk"
"408","90",5,12,9,3,0.75,"pre","mcm","hk"
"409","90",8,12,9,3,0.75,"pre","mcm","hk"
"410","90",11,12,3,9,0.25,"pre","mcm","hk"
"411","90",14,12,3,9,0.25,"pre","mcm","hk"
"412","90",17,12,2,10,0.166666666666667,"pre","mcm","hk"
"413","90",20,11,3,8,0.272727272727273,"pre","mcm","hk"
"414","135",3,12,5,7,0.416666666666667,"pre","mcm","hk"
"415","135",5,12,6,6,0.5,"pre","mcm","hk"
"416","135",8,11,8,3,0.727272727272727,"pre","mcm","hk"
"417","135",11,12,9,3,0.75,"pre","mcm","hk"
"418","135",14,12,5,7,0.416666666666667,"pre","mcm","hk"
"419","135",17,12,3,9,0.25,"pre","mcm","hk"
"420","135",20,12,3,9,0.25,"pre","mcm","hk"
"421","0",3,9,4,5,0.444444444444444,"pos","aaf","cl"
"422","0",5,7,4,3,0.571428571428571,"pos","aaf","cl"
"423","0",8,13,8,5,0.615384615384615,"pos","aaf","cl"
"424","0",11,9,2,7,0.222222222222222,"pos","aaf","cl"
"425","0",14,15,7,8,0.466666666666667,"pos","aaf","cl"
"426","0",17,14,2,12,0.142857142857143,"pos","aaf","cl"
"427","0",20,17,1,16,0.0588235294117647,"pos","aaf","cl"
"428","135",3,14,5,9,0.357142857142857,"pos","aaf","cl"
"429","135",5,11,5,6,0.454545454545455,"pos","aaf","cl"
"430","135",8,12,8,4,0.666666666666667,"pos","aaf","cl"
"431","135",11,16,8,8,0.5,"pos","aaf","cl"
"432","135",14,10,5,5,0.5,"pos","aaf","cl"
"433","135",17,11,2,9,0.181818181818182,"pos","aaf","cl"
"434","135",20,10,3,7,0.3,"pos","aaf","cl"
"435","45",3,13,8,5,0.615384615384615,"pos","aaf","cl"
"436","45",5,16,6,10,0.375,"pos","aaf","cl"
"437","45",8,14,4,10,0.285714285714286,"pos","aaf","cl"
"438","45",11,8,3,5,0.375,"pos","aaf","cl"
"439","45",14,14,6,8,0.428571428571429,"pos","aaf","cl"
"440","45",17,12,0,12,0,"pos","aaf","cl"
"441","45",20,7,3,4,0.428571428571429,"pos","aaf","cl"
"442","90",3,12,7,5,0.583333333333333,"pos","aaf","cl"
"443","90",5,14,4,10,0.285714285714286,"pos","aaf","cl"
"444","90",8,9,8,1,0.888888888888889,"pos","aaf","cl"
"445","90",11,15,5,10,0.333333333333333,"pos","aaf","cl"
"446","90",14,9,3,6,0.333333333333333,"pos","aaf","cl"
"447","90",17,11,4,7,0.363636363636364,"pos","aaf","cl"
"448","90",20,13,4,9,0.307692307692308,"pos","aaf","cl"
"449","0",3,9,6,3,0.666666666666667,"pos","afb","rt"
"450","0",5,7,5,2,0.714285714285714,"pos","afb","rt"
"451","0",8,13,8,5,0.615384615384615,"pos","afb","rt"
"452","0",11,9,4,5,0.444444444444444,"pos","afb","rt"
"453","0",14,15,6,9,0.4,"pos","afb","rt"
"454","0",17,14,5,9,0.357142857142857,"pos","afb","rt"
"455","0",20,17,7,10,0.411764705882353,"pos","afb","rt"
"456","135",3,14,12,2,0.857142857142857,"pos","afb","rt"
"457","135",5,11,9,2,0.818181818181818,"pos","afb","rt"
"458","135",8,12,7,5,0.583333333333333,"pos","afb","rt"
"459","135",11,16,10,6,0.625,"pos","afb","rt"
"460","135",14,10,7,3,0.7,"pos","afb","rt"
"461","135",17,11,5,6,0.454545454545455,"pos","afb","rt"
"462","135",20,10,3,7,0.3,"pos","afb","rt"
"463","45",3,12,9,3,0.75,"pos","afb","rt"
"464","45",5,16,13,3,0.8125,"pos","afb","rt"
"465","45",8,14,9,5,0.642857142857143,"pos","afb","rt"
"466","45",11,8,4,4,0.5,"pos","afb","rt"
"467","45",14,14,5,9,0.357142857142857,"pos","afb","rt"
"468","45",17,12,9,3,0.75,"pos","afb","rt"
"469","45",20,7,3,4,0.428571428571429,"pos","afb","rt"
"470","90",3,12,7,5,0.583333333333333,"pos","afb","rt"
"471","90",5,14,8,6,0.571428571428571,"pos","afb","rt"
"472","90",8,9,2,7,0.222222222222222,"pos","afb","rt"
"473","90",11,15,6,9,0.4,"pos","afb","rt"
"474","90",14,9,2,7,0.222222222222222,"pos","afb","rt"
"475","90",17,11,2,9,0.181818181818182,"pos","afb","rt"
"476","90",20,13,6,7,0.461538461538462,"pos","afb","rt"
"477","0",3,9,6,3,0.666666666666667,"pos","agm","cl"
"478","0",5,7,6,1,0.857142857142857,"pos","agm","cl"
"479","0",8,13,8,5,0.615384615384615,"pos","agm","cl"
"480","0",11,8,3,5,0.375,"pos","agm","cl"
"481","0",14,15,5,10,0.333333333333333,"pos","agm","cl"
"482","0",17,14,4,10,0.285714285714286,"pos","agm","cl"
"483","0",20,17,4,13,0.235294117647059,"pos","agm","cl"
"484","135",3,14,8,6,0.571428571428571,"pos","agm","cl"
"485","135",5,11,6,5,0.545454545454545,"pos","agm","cl"
"486","135",8,12,6,6,0.5,"pos","agm","cl"
"487","135",11,16,9,7,0.5625,"pos","agm","cl"
"488","135",14,10,4,6,0.4,"pos","agm","cl"
"489","135",17,11,3,8,0.272727272727273,"pos","agm","cl"
"490","135",20,10,3,7,0.3,"pos","agm","cl"
"491","45",3,13,12,1,0.923076923076923,"pos","agm","cl"
"492","45",5,16,11,5,0.6875,"pos","agm","cl"
"493","45",8,14,10,4,0.714285714285714,"pos","agm","cl"
"494","45",11,8,5,3,0.625,"pos","agm","cl"
"495","45",14,14,8,6,0.571428571428571,"pos","agm","cl"
"496","45",17,12,4,8,0.333333333333333,"pos","agm","cl"
"497","45",20,7,2,5,0.285714285714286,"pos","agm","cl"
"498","90",3,12,6,6,0.5,"pos","agm","cl"
"499","90",5,14,9,5,0.642857142857143,"pos","agm","cl"
"500","90",8,8,3,5,0.375,"pos","agm","cl"
"501","90",11,15,6,9,0.4,"pos","agm","cl"
"502","90",14,9,5,4,0.555555555555556,"pos","agm","cl"
"503","90",17,11,2,9,0.181818181818182,"pos","agm","cl"
"504","90",20,13,0,13,0,"pos","agm","cl"
"505","0",3,9,5,4,0.555555555555556,"pos","cic","rt"
"506","0",5,7,6,1,0.857142857142857,"pos","cic","rt"
"507","0",8,13,10,3,0.769230769230769,"pos","cic","rt"
"508","0",11,9,2,7,0.222222222222222,"pos","cic","rt"
"509","0",14,15,6,9,0.4,"pos","cic","rt"
"510","0",17,14,7,7,0.5,"pos","cic","rt"
"511","0",20,16,6,10,0.375,"pos","cic","rt"
"512","135",3,14,6,8,0.428571428571429,"pos","cic","rt"
"513","135",5,10,8,2,0.8,"pos","cic","rt"
"514","135",8,12,6,6,0.5,"pos","cic","rt"
"515","135",11,16,10,6,0.625,"pos","cic","rt"
"516","135",14,10,4,6,0.4,"pos","cic","rt"
"517","135",17,11,4,7,0.363636363636364,"pos","cic","rt"
"518","135",20,10,5,5,0.5,"pos","cic","rt"
"519","45",3,13,8,5,0.615384615384615,"pos","cic","rt"
"520","45",5,16,10,6,0.625,"pos","cic","rt"
"521","45",8,14,5,9,0.357142857142857,"pos","cic","rt"
"522","45",11,8,4,4,0.5,"pos","cic","rt"
"523","45",14,14,7,7,0.5,"pos","cic","rt"
"524","45",17,12,5,7,0.416666666666667,"pos","cic","rt"
"525","45",20,7,1,6,0.142857142857143,"pos","cic","rt"
"526","90",3,12,8,4,0.666666666666667,"pos","cic","rt"
"527","90",5,14,7,7,0.5,"pos","cic","rt"
"528","90",8,9,5,4,0.555555555555556,"pos","cic","rt"
"529","90",11,15,7,8,0.466666666666667,"pos","cic","rt"
"530","90",14,9,6,3,0.666666666666667,"pos","cic","rt"
"531","90",17,11,2,9,0.181818181818182,"pos","cic","rt"
"532","90",20,12,3,9,0.25,"pos","cic","rt"
"533","0",3,9,6,3,0.666666666666667,"pos","jjr","lt"
"534","0",5,7,5,2,0.714285714285714,"pos","jjr","lt"
"535","0",8,13,12,1,0.923076923076923,"pos","jjr","lt"
"536","0",11,9,5,4,0.555555555555556,"pos","jjr","lt"
"537","0",14,15,6,9,0.4,"pos","jjr","lt"
"538","0",17,14,2,12,0.142857142857143,"pos","jjr","lt"
"539","0",20,17,1,16,0.0588235294117647,"pos","jjr","lt"
"540","135",3,14,12,2,0.857142857142857,"pos","jjr","lt"
"541","135",5,11,8,3,0.727272727272727,"pos","jjr","lt"
"542","135",8,12,4,8,0.333333333333333,"pos","jjr","lt"
"543","135",11,16,5,11,0.3125,"pos","jjr","lt"
"544","135",14,10,2,8,0.2,"pos","jjr","lt"
"545","135",17,10,4,6,0.4,"pos","jjr","lt"
"546","135",20,10,2,8,0.2,"pos","jjr","lt"
"547","45",3,13,9,4,0.692307692307692,"pos","jjr","lt"
"548","45",5,15,12,3,0.8,"pos","jjr","lt"
"549","45",8,14,8,6,0.571428571428571,"pos","jjr","lt"
"550","45",11,8,2,6,0.25,"pos","jjr","lt"
"551","45",14,14,9,5,0.642857142857143,"pos","jjr","lt"
"552","45",17,12,3,9,0.25,"pos","jjr","lt"
"553","45",20,7,1,6,0.142857142857143,"pos","jjr","lt"
"554","90",3,12,8,4,0.666666666666667,"pos","jjr","lt"
"555","90",5,14,9,5,0.642857142857143,"pos","jjr","lt"
"556","90",8,9,5,4,0.555555555555556,"pos","jjr","lt"
"557","90",11,15,8,7,0.533333333333333,"pos","jjr","lt"
"558","90",14,9,4,5,0.444444444444444,"pos","jjr","lt"
"559","90",17,11,2,9,0.181818181818182,"pos","jjr","lt"
"560","90",20,13,2,11,0.153846153846154,"pos","jjr","lt"
"561","0",3,9,7,2,0.777777777777778,"pos","lrc","cl"
"562","0",5,7,5,2,0.714285714285714,"pos","lrc","cl"
"563","0",8,13,9,4,0.692307692307692,"pos","lrc","cl"
"564","0",11,8,3,5,0.375,"pos","lrc","cl"
"565","0",14,14,5,9,0.357142857142857,"pos","lrc","cl"
"566","0",17,14,1,13,0.0714285714285714,"pos","lrc","cl"
"567","0",20,17,3,14,0.176470588235294,"pos","lrc","cl"
"568","135",3,14,10,4,0.714285714285714,"pos","lrc","cl"
"569","135",5,11,8,3,0.727272727272727,"pos","lrc","cl"
"570","135",8,12,7,5,0.583333333333333,"pos","lrc","cl"
"571","135",11,16,6,10,0.375,"pos","lrc","cl"
"572","135",14,10,1,9,0.1,"pos","lrc","cl"
"573","135",17,11,6,5,0.545454545454545,"pos","lrc","cl"
"574","135",20,10,3,7,0.3,"pos","lrc","cl"
"575","45",3,13,7,6,0.538461538461538,"pos","lrc","cl"
"576","45",5,15,9,6,0.6,"pos","lrc","cl"
"577","45",8,14,8,6,0.571428571428571,"pos","lrc","cl"
"578","45",11,8,5,3,0.625,"pos","lrc","cl"
"579","45",14,14,6,8,0.428571428571429,"pos","lrc","cl"
"580","45",17,11,1,10,0.0909090909090909,"pos","lrc","cl"
"581","45",20,7,1,6,0.142857142857143,"pos","lrc","cl"
"582","90",3,12,11,1,0.916666666666667,"pos","lrc","cl"
"583","90",5,14,11,3,0.785714285714286,"pos","lrc","cl"
"584","90",8,9,2,7,0.222222222222222,"pos","lrc","cl"
"585","90",11,15,7,8,0.466666666666667,"pos","lrc","cl"
"586","90",14,9,3,6,0.333333333333333,"pos","lrc","cl"
"587","90",17,11,3,8,0.272727272727273,"pos","lrc","cl"
"588","90",20,12,0,12,0,"pos","lrc","cl"
"589","0",3,9,5,4,0.555555555555556,"pos","mab","lt"
"590","0",5,7,5,2,0.714285714285714,"pos","mab","lt"
"591","0",8,13,13,0,1,"pos","mab","lt"
"592","0",11,9,5,4,0.555555555555556,"pos","mab","lt"
"593","0",14,15,6,9,0.4,"pos","mab","lt"
"594","0",17,14,2,12,0.142857142857143,"pos","mab","lt"
"595","0",20,16,6,10,0.375,"pos","mab","lt"
"596","135",3,14,11,3,0.785714285714286,"pos","mab","lt"
"597","135",5,11,10,1,0.909090909090909,"pos","mab","lt"
"598","135",8,12,8,4,0.666666666666667,"pos","mab","lt"
"599","135",11,16,10,6,0.625,"pos","mab","lt"
"600","135",14,9,6,3,0.666666666666667,"pos","mab","lt"
"601","135",17,11,2,9,0.181818181818182,"pos","mab","lt"
"602","135",20,10,5,5,0.5,"pos","mab","lt"
"603","45",3,13,11,2,0.846153846153846,"pos","mab","lt"
"604","45",5,16,11,5,0.6875,"pos","mab","lt"
"605","45",8,14,13,1,0.928571428571429,"pos","mab","lt"
"606","45",11,8,7,1,0.875,"pos","mab","lt"
"607","45",14,14,7,7,0.5,"pos","mab","lt"
"608","45",17,12,8,4,0.666666666666667,"pos","mab","lt"
"609","45",20,7,2,5,0.285714285714286,"pos","mab","lt"
"610","90",3,11,10,1,0.909090909090909,"pos","mab","lt"
"611","90",5,13,11,2,0.846153846153846,"pos","mab","lt"
"612","90",8,9,7,2,0.777777777777778,"pos","mab","lt"
"613","90",11,15,14,1,0.933333333333333,"pos","mab","lt"
"614","90",14,9,4,5,0.444444444444444,"pos","mab","lt"
"615","90",17,11,6,5,0.545454545454545,"pos","mab","lt"
"616","90",20,13,4,9,0.307692307692308,"pos","mab","lt"
"617","0",3,8,6,2,0.75,"pos","mdn","lt"
"618","0",5,7,4,3,0.571428571428571,"pos","mdn","lt"
"619","0",8,13,9,4,0.692307692307692,"pos","mdn","lt"
"620","0",11,9,3,6,0.333333333333333,"pos","mdn","lt"
"621","0",14,14,5,9,0.357142857142857,"pos","mdn","lt"
"622","0",17,13,3,10,0.230769230769231,"pos","mdn","lt"
"623","0",20,16,1,15,0.0625,"pos","mdn","lt"
"624","135",3,14,10,4,0.714285714285714,"pos","mdn","lt"
"625","135",5,11,9,2,0.818181818181818,"pos","mdn","lt"
"626","135",8,12,7,5,0.583333333333333,"pos","mdn","lt"
"627","135",11,15,9,6,0.6,"pos","mdn","lt"
"628","135",14,10,2,8,0.2,"pos","mdn","lt"
"629","135",17,11,1,10,0.0909090909090909,"pos","mdn","lt"
"630","135",20,10,3,7,0.3,"pos","mdn","lt"
"631","45",3,13,12,1,0.923076923076923,"pos","mdn","lt"
"632","45",5,15,6,9,0.4,"pos","mdn","lt"
"633","45",8,14,7,7,0.5,"pos","mdn","lt"
"634","45",11,8,4,4,0.5,"pos","mdn","lt"
"635","45",14,14,6,8,0.428571428571429,"pos","mdn","lt"
"636","45",17,12,3,9,0.25,"pos","mdn","lt"
"637","45",20,7,1,6,0.142857142857143,"pos","mdn","lt"
"638","90",3,12,5,7,0.416666666666667,"pos","mdn","lt"
"639","90",5,14,10,4,0.714285714285714,"pos","mdn","lt"
"640","90",8,9,3,6,0.333333333333333,"pos","mdn","lt"
"641","90",11,14,6,8,0.428571428571429,"pos","mdn","lt"
"642","90",14,9,2,7,0.222222222222222,"pos","mdn","lt"
"643","90",17,10,2,8,0.2,"pos","mdn","lt"
"644","90",20,13,1,12,0.0769230769230769,"pos","mdn","lt"
"645","0",3,9,9,0,1,"pos","msz","rt"
"646","0",5,7,4,3,0.571428571428571,"pos","msz","rt"
"647","0",8,13,7,6,0.538461538461538,"pos","msz","rt"
"648","0",11,9,2,7,0.222222222222222,"pos","msz","rt"
"649","0",14,15,3,12,0.2,"pos","msz","rt"
"650","0",17,14,1,13,0.0714285714285714,"pos","msz","rt"
"651","0",20,17,3,14,0.176470588235294,"pos","msz","rt"
"652","135",3,14,13,1,0.928571428571429,"pos","msz","rt"
"653","135",5,11,5,6,0.454545454545455,"pos","msz","rt"
"654","135",8,12,4,8,0.333333333333333,"pos","msz","rt"
"655","135",11,16,6,10,0.375,"pos","msz","rt"
"656","135",14,10,1,9,0.1,"pos","msz","rt"
"657","135",17,11,1,10,0.0909090909090909,"pos","msz","rt"
"658","135",20,10,2,8,0.2,"pos","msz","rt"
"659","45",3,13,13,0,1,"pos","msz","rt"
"660","45",5,16,10,6,0.625,"pos","msz","rt"
"661","45",8,14,5,9,0.357142857142857,"pos","msz","rt"
"662","45",11,8,2,6,0.25,"pos","msz","rt"
"663","45",14,12,2,10,0.166666666666667,"pos","msz","rt"
"664","45",17,12,2,10,0.166666666666667,"pos","msz","rt"
"665","45",20,7,0,7,0,"pos","msz","rt"
"666","90",3,12,11,1,0.916666666666667,"pos","msz","rt"
"667","90",5,14,10,4,0.714285714285714,"pos","msz","rt"
"668","90",8,9,4,5,0.444444444444444,"pos","msz","rt"
"669","90",11,15,6,9,0.4,"pos","msz","rt"
"670","90",14,9,2,7,0.222222222222222,"pos","msz","rt"
"671","90",17,11,1,10,0.0909090909090909,"pos","msz","rt"
"672","90",20,13,3,10,0.230769230769231,"pos","msz","rt"
"673","0",3,8,7,1,0.875,"pos","nga","rt"
"674","0",5,7,4,3,0.571428571428571,"pos","nga","rt"
"675","0",8,12,8,4,0.666666666666667,"pos","nga","rt"
"676","0",11,8,2,6,0.25,"pos","nga","rt"
"677","0",14,15,4,11,0.266666666666667,"pos","nga","rt"
"678","0",17,13,3,10,0.230769230769231,"pos","nga","rt"
"679","0",20,17,4,13,0.235294117647059,"pos","nga","rt"
"680","135",3,13,9,4,0.692307692307692,"pos","nga","rt"
"681","135",5,11,5,6,0.454545454545455,"pos","nga","rt"
"682","135",8,11,5,6,0.454545454545455,"pos","nga","rt"
"683","135",11,16,7,9,0.4375,"pos","nga","rt"
"684","135",14,10,4,6,0.4,"pos","nga","rt"
"685","135",17,11,0,11,0,"pos","nga","rt"
"686","135",20,10,3,7,0.3,"pos","nga","rt"
"687","45",3,13,9,4,0.692307692307692,"pos","nga","rt"
"688","45",5,16,8,8,0.5,"pos","nga","rt"
"689","45",8,13,8,5,0.615384615384615,"pos","nga","rt"
"690","45",11,7,3,4,0.428571428571429,"pos","nga","rt"
"691","45",14,14,4,10,0.285714285714286,"pos","nga","rt"
"692","45",17,11,2,9,0.181818181818182,"pos","nga","rt"
"693","45",20,7,2,5,0.285714285714286,"pos","nga","rt"
"694","90",3,11,8,3,0.727272727272727,"pos","nga","rt"
"695","90",5,14,8,6,0.571428571428571,"pos","nga","rt"
"696","90",8,6,1,5,0.166666666666667,"pos","nga","rt"
"697","90",11,13,4,9,0.307692307692308,"pos","nga","rt"
"698","90",14,9,5,4,0.555555555555556,"pos","nga","rt"
"699","90",17,11,3,8,0.272727272727273,"pos","nga","rt"
"700","90",20,13,7,6,0.538461538461538,"pos","nga","rt"
"701","0",3,9,7,2,0.777777777777778,"pos","pab","cl"
"702","0",5,6,6,0,1,"pos","pab","cl"
"703","0",8,13,11,2,0.846153846153846,"pos","pab","cl"
"704","0",11,8,6,2,0.75,"pos","pab","cl"
"705","0",14,15,10,5,0.666666666666667,"pos","pab","cl"
"706","0",17,14,6,8,0.428571428571429,"pos","pab","cl"
"707","0",20,17,8,9,0.470588235294118,"pos","pab","cl"
"708","135",3,14,13,1,0.928571428571429,"pos","pab","cl"
"709","135",5,11,11,0,1,"pos","pab","cl"
"710","135",8,10,10,0,1,"pos","pab","cl"
"711","135",11,16,10,6,0.625,"pos","pab","cl"
"712","135",14,10,3,7,0.3,"pos","pab","cl"
"713","135",17,11,1,10,0.0909090909090909,"pos","pab","cl"
"714","135",20,10,1,9,0.1,"pos","pab","cl"
"715","45",3,12,11,1,0.916666666666667,"pos","pab","cl"
"716","45",5,16,15,1,0.9375,"pos","pab","cl"
"717","45",8,14,11,3,0.785714285714286,"pos","pab","cl"
"718","45",11,7,7,0,1,"pos","pab","cl"
"719","45",14,14,6,8,0.428571428571429,"pos","pab","cl"
"720","45",17,12,5,7,0.416666666666667,"pos","pab","cl"
"721","45",20,7,3,4,0.428571428571429,"pos","pab","cl"
"722","90",3,11,9,2,0.818181818181818,"pos","pab","cl"
"723","90",5,13,13,0,1,"pos","pab","cl"
"724","90",8,9,8,1,0.888888888888889,"pos","pab","cl"
"725","90",11,15,6,9,0.4,"pos","pab","cl"
"726","90",14,9,5,4,0.555555555555556,"pos","pab","cl"
"727","90",17,11,5,6,0.454545454545455,"pos","pab","cl"
"728","90",20,13,4,9,0.307692307692308,"pos","pab","cl"
"729","0",3,12,12,0,1,"pos","at-","hk"
"730","0",5,11,9,2,0.818181818181818,"pos","at-","hk"
"731","0",8,12,12,0,1,"pos","at-","hk"
"732","0",11,11,9,2,0.818181818181818,"pos","at-","hk"
"733","0",14,12,5,7,0.416666666666667,"pos","at-","hk"
"734","0",17,11,8,3,0.727272727272727,"pos","at-","hk"
"735","0",20,12,5,7,0.416666666666667,"pos","at-","hk"
"736","45",3,12,12,0,1,"pos","at-","hk"
"737","45",5,12,9,3,0.75,"pos","at-","hk"
"738","45",8,12,8,4,0.666666666666667,"pos","at-","hk"
"739","45",11,11,10,1,0.909090909090909,"pos","at-","hk"
"740","45",14,12,5,7,0.416666666666667,"pos","at-","hk"
"741","45",17,12,5,7,0.416666666666667,"pos","at-","hk"
"742","45",20,12,4,8,0.333333333333333,"pos","at-","hk"
"743","90",3,12,10,2,0.833333333333333,"pos","at-","hk"
"744","90",5,11,10,1,0.909090909090909,"pos","at-","hk"
"745","90",8,12,10,2,0.833333333333333,"pos","at-","hk"
"746","90",11,12,8,4,0.666666666666667,"pos","at-","hk"
"747","90",14,12,9,3,0.75,"pos","at-","hk"
"748","90",17,12,7,5,0.583333333333333,"pos","at-","hk"
"749","90",20,12,4,8,0.333333333333333,"pos","at-","hk"
"750","135",3,12,11,1,0.916666666666667,"pos","at-","hk"
"751","135",5,12,9,3,0.75,"pos","at-","hk"
"752","135",8,12,9,3,0.75,"pos","at-","hk"
"753","135",11,12,6,6,0.5,"pos","at-","hk"
"754","135",14,12,7,5,0.583333333333333,"pos","at-","hk"
"755","135",17,12,7,5,0.583333333333333,"pos","at-","hk"
"756","135",20,12,5,7,0.416666666666667,"pos","at-","hk"
"757","0",3,12,11,1,0.916666666666667,"pos","lfa","hk"
"758","0",5,12,11,1,0.916666666666667,"pos","lfa","hk"
"759","0",8,12,10,2,0.833333333333333,"pos","lfa","hk"
"760","0",11,12,8,4,0.666666666666667,"pos","lfa","hk"
"761","0",14,12,6,6,0.5,"pos","lfa","hk"
"762","0",17,11,4,7,0.363636363636364,"pos","lfa","hk"
"763","0",20,11,4,7,0.363636363636364,"pos","lfa","hk"
"764","45",3,12,10,2,0.833333333333333,"pos","lfa","hk"
"765","45",5,12,7,5,0.583333333333333,"pos","lfa","hk"
"766","45",8,12,7,5,0.583333333333333,"pos","lfa","hk"
"767","45",11,11,7,4,0.636363636363636,"pos","lfa","hk"
"768","45",14,12,3,9,0.25,"pos","lfa","hk"
"769","45",17,12,2,10,0.166666666666667,"pos","lfa","hk"
"770","45",20,12,5,7,0.416666666666667,"pos","lfa","hk"
"771","90",3,12,9,3,0.75,"pos","lfa","hk"
"772","90",5,12,9,3,0.75,"pos","lfa","hk"
"773","90",8,12,9,3,0.75,"pos","lfa","hk"
"774","90",11,11,6,5,0.545454545454545,"pos","lfa","hk"
"775","90",14,12,4,8,0.333333333333333,"pos","lfa","hk"
"776","90",17,12,3,9,0.25,"pos","lfa","hk"
"777","90",20,12,3,9,0.25,"pos","lfa","hk"
"778","135",3,12,12,0,1,"pos","lfa","hk"
"779","135",5,12,7,5,0.583333333333333,"pos","lfa","hk"
"780","135",8,12,7,5,0.583333333333333,"pos","lfa","hk"
"781","135",11,12,8,4,0.666666666666667,"pos","lfa","hk"
"782","135",14,12,3,9,0.25,"pos","lfa","hk"
"783","135",17,12,5,7,0.416666666666667,"pos","lfa","hk"
"784","135",20,12,3,9,0.25,"pos","lfa","hk"
"785","0",3,10,8,2,0.8,"pos","lms","hk"
"786","0",5,12,9,3,0.75,"pos","lms","hk"
"787","0",8,11,9,2,0.818181818181818,"pos","lms","hk"
"788","0",11,12,8,4,0.666666666666667,"pos","lms","hk"
"789","0",14,11,3,8,0.272727272727273,"pos","lms","hk"
"790","0",17,11,4,7,0.363636363636364,"pos","lms","hk"
"791","0",20,10,4,6,0.4,"pos","lms","hk"
"792","45",3,10,9,1,0.9,"pos","lms","hk"
"793","45",5,11,8,3,0.727272727272727,"pos","lms","hk"
"794","45",8,11,6,5,0.545454545454545,"pos","lms","hk"
"795","45",11,10,6,4,0.6,"pos","lms","hk"
"796","45",14,12,2,10,0.166666666666667,"pos","lms","hk"
"797","45",17,12,4,8,0.333333333333333,"pos","lms","hk"
"798","45",20,12,4,8,0.333333333333333,"pos","lms","hk"
"799","90",3,10,7,3,0.7,"pos","lms","hk"
"800","90",5,11,10,1,0.909090909090909,"pos","lms","hk"
"801","90",8,10,7,3,0.7,"pos","lms","hk"
"802","90",11,11,9,2,0.818181818181818,"pos","lms","hk"
"803","90",14,12,5,7,0.416666666666667,"pos","lms","hk"
"804","90",17,9,4,5,0.444444444444444,"pos","lms","hk"
"805","90",20,12,3,9,0.25,"pos","lms","hk"
"806","135",3,11,7,4,0.636363636363636,"pos","lms","hk"
"807","135",5,9,6,3,0.666666666666667,"pos","lms","hk"
"808","135",8,11,6,5,0.545454545454545,"pos","lms","hk"
"809","135",11,11,3,8,0.272727272727273,"pos","lms","hk"
"810","135",14,12,5,7,0.416666666666667,"pos","lms","hk"
"811","135",17,11,5,6,0.454545454545455,"pos","lms","hk"
"812","135",20,11,2,9,0.181818181818182,"pos","lms","hk"
"813","0",3,12,12,0,1,"pos","mcm","hk"
"814","0",5,12,9,3,0.75,"pos","mcm","hk"
"815","0",8,12,8,4,0.666666666666667,"pos","mcm","hk"
"816","0",11,11,4,7,0.363636363636364,"pos","mcm","hk"
"817","0",14,12,5,7,0.416666666666667,"pos","mcm","hk"
"818","0",17,12,6,6,0.5,"pos","mcm","hk"
"819","0",20,12,0,12,0,"pos","mcm","hk"
"820","45",3,12,9,3,0.75,"pos","mcm","hk"
"821","45",5,12,8,4,0.666666666666667,"pos","mcm","hk"
"822","45",8,12,6,6,0.5,"pos","mcm","hk"
"823","45",11,11,7,4,0.636363636363636,"pos","mcm","hk"
"824","45",14,12,4,8,0.333333333333333,"pos","mcm","hk"
"825","45",17,12,2,10,0.166666666666667,"pos","mcm","hk"
"826","45",20,12,5,7,0.416666666666667,"pos","mcm","hk"
"827","90",3,12,8,4,0.666666666666667,"pos","mcm","hk"
"828","90",5,12,9,3,0.75,"pos","mcm","hk"
"829","90",8,12,6,6,0.5,"pos","mcm","hk"
"830","90",11,12,6,6,0.5,"pos","mcm","hk"
"831","90",14,12,4,8,0.333333333333333,"pos","mcm","hk"
"832","90",17,12,5,7,0.416666666666667,"pos","mcm","hk"
"833","90",20,12,6,6,0.5,"pos","mcm","hk"
"834","135",3,12,8,4,0.666666666666667,"pos","mcm","hk"
"835","135",5,12,10,2,0.833333333333333,"pos","mcm","hk"
"836","135",8,12,5,7,0.416666666666667,"pos","mcm","hk"
"837","135",11,12,7,5,0.583333333333333,"pos","mcm","hk"
"838","135",14,12,5,7,0.416666666666667,"pos","mcm","hk"
"839","135",17,12,4,8,0.333333333333333,"pos","mcm","hk"
"840","135",20,12,2,10,0.166666666666667,"pos","mcm","hk"
